#####################
#S.................S#
#.#####.#####.#####.#
#.................#.#
#.###.#########.###.#
#...#.....O.....#...#
#.###.#########.###.#
#.................#.#
#.#####.#####.#####.#
#S.................S#
#####################


