###################
#S..X.X.X.X.X.X..S#
#.#X#.#.#.#.#.#X#.#
#X.X.X.X.X.X.X.X.X#
#.#.#X#.#.#.#X#.#.#
#X.X.X.X.X.X.X.X.X#
#.#.#.#.#O#.#.#.#.#
#X.X.X.X.X.X.X.X.X#
#.#.#X#.#.#.#X#.#.#
#X.X.X.X.X.X.X.X.X#
#.#X#.#.#.#.#.#X#.#
#S..X.X.X.X.X.X..S#
###################
