#########################
#S.X#.......#.......#X.S#
#.#.#.#####.#.#####.#.#.#
#.X.#...#.........#...X.#
###.###.#.#######.#.###.#
#.....#.#.#.....#.#.#...#
#.###.#.#.#.###.#.#.#.###
#...#.....#..O..#.....#.#
#.#.###########.#####.#.#
#.#.....#.....#.....#...#
#.#####.#.###.#####.#####
#.......#.....#.........#
#S.X#.......#.......#X.S#
#########################


